7 0 0 0 0 0 0 0 1 2 2 3 2 1 0 0 0 0 0 8
0 0 0 0 0 0 0 1 1 2 3 3 2 1 0 0 0 0 0 0
0 0 0 0 0 0 0 0 1 2 3 2 2 1 1 0 0 0 0 0
0 0 0 0 0 0 0 0 1 2 3 3 2 1 0 0 0 0 0 0
0 0 0 0 0 0 0 0 1 2 2 3 2 1 0 0 0 0 0 0
0 0 0 0 0 0 0 0 1 1 2 3 2 1 1 0 0 0 0 0
0 0 0 0 0 0 0 0 0 1 2 3 2 2 1 0 0 0 0 0
0 0 0 0 0 0 0 0 0 1 2 3 2 1 1 0 0 0 0 0
0 0 0 0 0 0 1 1 1 1 2 3 2 1 0 0 0 0 0 0
0 0 0 0 0 1 1 2 2 2 2 3 2 1 0 0 0 0 0 0
0 0 0 0 0 0 1 2 3 3 3 3 2 1 0 0 0 0 0 0
0 0 0 0 0 0 1 2 3 2 2 2 2 1 0 0 0 0 0 0
0 0 0 0 0 0 1 2 3 3 2 1 1 1 0 0 0 0 0 0
0 0 0 0 0 1 1 2 2 3 2 1 0 0 0 0 0 0 0 0
0 0 0 0 0 1 1 1 2 3 2 1 1 0 0 0 0 0 0 0
0 0 0 0 0 0 1 2 2 3 2 1 0 0 0 0 0 0 0 0
0 0 0 0 0 1 1 2 3 3 2 1 0 0 0 0 0 0 0 0
0 0 0 0 0 1 2 2 3 2 2 1 1 0 0 0 0 0 0 0
0 0 0 0 0 1 2 3 3 2 1 1 0 0 0 0 0 0 0 0
5 0 0 0 0 1 2 3 2 2 1 0 0 0 0 0 0 0 0 6
5 0 0 0 0 1 2 3 2 2 1 0 0 0 0 0 0 0 0 6